mirna	FP	FPc	FN	FNc	TP	TPc	counts	hits	total_species	filtered_hits	TPR	TPRc	PPV	PPVc	MCC	MCCc
Mir-1677	55470	2242	0	8	32	24	32	55502	9	2266	1	0.75	5.765557997909985e-4	0.01059135039717564	0.02401157637038848	0.08912638665334599
Mir-7262	3050	22	0	1	14	13	14	3064	2	35	1	0.9285714285714286	0.0045691906005221935	0.37142857142857144	0.06759578833420166	0.5872801368884133
Mir-4872	177	64	0	4	50	46	50	227	2	110	1	0.92	0.22026431718061673	0.41818181818181815	0.4693232544639321	0.6202638734661827
Mir-1998	4	3	0	0	2	2	2	6	2	5	1	1	0.3333333333333333	0.4	0.5773502691896257	0.6324555320336759
Mir-430	458	394	32	35	408	405	440	866	35	799	0.9272727272727272	0.9204545454545454	0.47113163972286376	0.5068836045056321	0.6609595452599892	0.6830544032385657
Mir-7392	6	0	0	1	2	1	2	8	2	1	1	0.5	0.25	1	0.5	0.7071067811865476
Mir-2005	2	2	0	0	2	2	2	4	2	4	1	1	0.5	0.5	0.7071067811865476	0.7071067811865476
Mir-7373	2054	17	0	15	55	40	55	2109	2	57	1	0.7272727272727273	0.026078710289236605	0.7017543859649122	0.1614890407713062	0.714399626369093
Mir-877	16	6	0	0	7	7	7	23	10	13	1	1	0.30434782608695654	0.5384615384615384	0.5516772843673705	0.7337993857053428
Mir-1997	5	5	0	0	6	6	6	11	2	11	1	1	0.5454545454545454	0.5454545454545454	0.7385489458759964	0.7385489458759964
Mir-734	3	3	0	0	4	4	4	7	5	7	1	1	0.5714285714285714	0.5714285714285714	0.7559289460184544	0.7559289460184544
Mir-7371	47	38	3	4	69	68	71	116	2	106	0.9583333333333334	0.9444444444444444	0.5948275862068966	0.6415094339622641	0.7550119889434047	0.778376529042571
Mir-242	22	3	0	3	15	12	14	37	71	15	1	0.8	0.40540540540540543	0.8	0.6367145399670133	0.8
Mir-2	74	74	28	28	222	222	243	296	28	296	0.888	0.888	0.75	0.75	0.8160882305241266	0.8160882305241266
Mir-4677	1	1	0	0	2	2	2	3	2	3	1	1	0.6666666666666666	0.6666666666666666	0.816496580927726	0.816496580927726
Mir-2002	4	1	0	0	2	2	2	6	2	3	1	1	0.3333333333333333	0.6666666666666666	0.5773502691896257	0.816496580927726
Mir-2004	2	1	0	0	2	2	2	4	2	3	1	1	0.5	0.6666666666666666	0.7071067811865476	0.816496580927726
Mir-2010	2	1	0	0	2	2	2	4	2	3	1	1	0.5	0.6666666666666666	0.7071067811865476	0.816496580927726
Mir-2707	2	1	0	0	2	2	2	4	2	3	1	1	0.5	0.6666666666666666	0.7071067811865476	0.816496580927726
Mir-147	62	7	0	3	27	24	26	89	35	31	1	0.8888888888888888	0.30337078651685395	0.7741935483870968	0.5507910552258941	0.8295613557843402
Mir-7398	25	16	0	2	44	42	44	69	2	58	1	0.9545454545454546	0.6376811594202898	0.7241379310344828	0.7985494095046904	0.8313979615881406
Mir-252	17	17	6	6	63	63	66	80	71	80	0.9130434782608695	0.9130434782608695	0.7875	0.7875	0.8479514957416107	0.8479514957416107
Mir-22	105	7	12	26	105	91	117	210	71	98	0.8974358974358975	0.7777777777777778	0.5	0.9285714285714286	0.6698641270570836	0.8498365855987975
Mir-219	116	24	0	10	106	96	106	222	71	120	1	0.9056603773584906	0.4774774774774775	0.8	0.6909974511367444	0.8511922825582904
Mir-1552	14	1	0	0	3	3	3	17	3	4	1	1	0.17647058823529413	0.75	0.42008402520840293	0.8660254037844386
Mir-2009	17	1	0	0	3	3	3	20	4	4	1	1	0.15	0.75	0.3872983346207417	0.8660254037844386
Mir-2000	1	1	0	0	3	3	3	4	2	4	1	1	0.75	0.75	0.8660254037844386	0.8660254037844386
Mir-154	36	36	42	42	268	268	304	304	10	304	0.864516129032258	0.864516129032258	0.881578947368421	0.881578947368421	0.8730058527955469	0.8730058527955469
Mir-36	18	7	6	10	63	59	69	81	28	66	0.9130434782608695	0.855072463768116	0.7777777777777778	0.8939393939393939	0.8427009716003844	0.8742899747996279
Mir-3	15	8	3	4	47	46	50	62	11	54	0.94	0.92	0.7580645161290323	0.8518518518518519	0.844144919525842	0.8852704127574262
Mir-506	32	19	5	9	118	114	123	150	10	133	0.959349593495935	0.926829268292683	0.7866666666666666	0.8571428571428571	0.8687280051221261	0.8913052715585239
Mir-193	71	18	8	24	192	176	199	263	71	194	0.96	0.88	0.7300380228136882	0.9072164948453608	0.8371597827781389	0.8935046253175848
Mir-2007	17	1	0	0	4	4	4	21	4	5	1	1	0.19047619047619047	0.8	0.4364357804719847	0.8944271909999159
Mir-2008	3	1	0	0	4	4	4	7	4	5	1	1	0.5714285714285714	0.8	0.7559289460184544	0.8944271909999159
Mir-2011	3	1	0	0	4	4	4	7	4	5	1	1	0.5714285714285714	0.8	0.7559289460184544	0.8944271909999159
Bantam	93	0	1	10	49	40	50	142	28	40	0.98	0.8	0.34507042253521125	1	0.5815230125149881	0.8944271909999159
Mir-1986	5	2	0	0	8	8	8	13	9	10	1	1	0.6153846153846154	0.8	0.7844645405527362	0.8944271909999159
Mir-96	54	16	10	28	216	198	226	270	71	214	0.9557522123893806	0.8761061946902655	0.8	0.9252336448598131	0.8744151016030685	0.9003348975784152
Mir-134	2	2	0	0	9	9	9	11	10	11	1	1	0.8181818181818182	0.8181818181818182	0.9045340337332909	0.9045340337332909
Mir-279	16	10	4	7	86	83	90	102	28	93	0.9555555555555556	0.9222222222222223	0.8431372549019608	0.8924731182795699	0.8975881505553809	0.9072257395011349
Mir-2690	1	1	0	0	5	5	5	6	2	6	1	1	0.8333333333333334	0.8333333333333334	0.9128709291752769	0.9128709291752769
Mir-87	23	9	0	3	67	64	67	90	28	73	1	0.9552238805970149	0.7444444444444445	0.8767123287671232	0.8628119403696524	0.9151265228656513
Mir-184	53	23	0	1	128	127	128	181	71	150	1	0.9921875	0.7071823204419889	0.8466666666666667	0.8409413299642187	0.9165435523385309
Mir-29	117	12	13	27	227	213	240	344	71	225	0.9458333333333333	0.8875	0.6598837209302325	0.9466666666666667	0.7900253283153932	0.916606058602422
Mir-92	59	32	17	23	311	305	328	370	71	337	0.948170731707317	0.9298780487804879	0.8405405405405405	0.9050445103857567	0.8927350891244211	0.9173772524850392
Mir-12	5	3	2	2	28	28	30	33	28	31	0.9333333333333333	0.9333333333333333	0.8484848484848485	0.9032258064516129	0.8898984166292195	0.9181561700975341
Mir-15	79	27	2	12	239	229	238	318	36	256	0.991701244813278	0.950207468879668	0.7515723270440252	0.89453125	0.8633279865131049	0.9219491715361892
Mir-216	45	10	5	9	121	117	126	166	71	127	0.9603174603174603	0.9285714285714286	0.7289156626506024	0.9212598425196851	0.8366543120920642	0.9249084106299355
Mir-10	26	26	44	44	434	434	463	460	73	460	0.9079497907949791	0.9079497907949791	0.9434782608695652	0.9434782608695652	0.9255435643858869	0.9255435643858869
Mir-2686	3	1	0	0	6	6	6	9	2	7	1	1	0.6666666666666666	0.8571428571428571	0.816496580927726	0.9258200997725514
Mir-315	15	4	1	1	31	31	32	46	71	35	0.96875	0.96875	0.6739130434782609	0.8857142857142857	0.8079933544711647	0.926302172234155
Mir-1329	10	1	1	2	20	19	21	30	35	20	0.9523809523809523	0.9047619047619048	0.6666666666666666	0.95	0.7968190728895957	0.9271050693011065
Mir-1993	18	2	0	1	21	20	21	39	28	22	1	0.9523809523809523	0.5384615384615384	0.9090909090909091	0.7337993857053428	0.9304842103984708
Mir-726	9	2	0	0	13	13	13	22	31	15	1	1	0.5909090909090909	0.8666666666666667	0.7687061147858074	0.9309493362512627
Mir-190	39	6	4	9	110	105	114	149	71	111	0.9649122807017544	0.9210526315789473	0.738255033557047	0.9459459459459459	0.8440090924682508	0.9334163073596636
Mir-197	10	1	0	0	7	7	7	17	10	8	1	1	0.4117647058823529	0.875	0.6416889479197478	0.9354143466934853
Mir-337	2	1	0	0	7	7	7	9	10	8	1	1	0.7777777777777778	0.875	0.8819171036881969	0.9354143466934853
Mir-7385	11	2	0	0	14	14	14	25	2	16	1	1	0.56	0.875	0.7483314773547883	0.9354143466934853
Mir-277	26	0	2	5	38	35	40	64	28	35	0.95	0.875	0.59375	1	0.7510409442899901	0.9354143466934853
Mir-1990	10	0	0	1	8	7	8	18	9	7	1	0.875	0.4444444444444444	1	0.6666666666666666	0.9354143466934853
Mir-76	32	5	0	0	36	36	36	68	71	41	1	1	0.5294117647058824	0.8780487804878049	0.7276068751089989	0.9370425713316364
Mir-31	17	11	0	0	85	85	85	102	71	96	1	1	0.8333333333333334	0.8854166666666666	0.9128709291752769	0.9409658158863512
Mir-2184	17	2	0	0	16	16	15	33	33	18	1	1	0.48484848484848486	0.8888888888888888	0.6963106238227914	0.9428090415820634
Mir-370	1	1	0	0	8	8	8	9	8	9	1	1	0.8888888888888888	0.8888888888888888	0.9428090415820634	0.9428090415820634
Mir-432	7	1	0	0	8	8	8	15	10	9	1	1	0.5333333333333333	0.8888888888888888	0.7302967433402214	0.9428090415820634
Mir-675	1	1	0	0	8	8	8	9	12	9	1	1	0.8888888888888888	0.8888888888888888	0.9428090415820634	0.9428090415820634
Mir-676	2	1	0	0	8	8	8	10	10	9	1	1	0.8	0.8888888888888888	0.8944271909999159	0.9428090415820634
Mir-760	2	0	1	1	8	8	9	10	10	8	0.8888888888888888	0.8888888888888888	0.8	1	0.8432740427115678	0.9428090415820634
Mir-376	8	5	0	0	41	41	41	49	10	46	1	1	0.8367346938775511	0.8913043478260869	0.9147320339189784	0.9440891630699332
Mir-451	39	3	0	1	35	34	35	74	35	37	1	0.9714285714285714	0.47297297297297297	0.918918918918919	0.6877303054053769	0.9448090244404383
Mir-320	33	0	0	2	19	17	19	52	10	17	1	0.8947368421052632	0.36538461538461536	1	0.6044705248269888	0.9459053029269173
Mir-488	1	1	0	0	9	9	9	10	10	10	1	1	0.9	0.9	0.9486832980505138	0.9486832980505138
Mir-541	3	1	0	0	9	9	9	12	10	10	1	1	0.75	0.9	0.8660254037844386	0.9486832980505138
Mir-544	3520	1	0	0	9	9	9	3529	10	10	1	1	0.0025502975347123833	0.9	0.050500470638523594	0.9486832980505138
Mir-724	1	1	0	0	9	9	9	10	5	10	1	1	0.9	0.9	0.9486832980505138	0.9486832980505138
Mir-316	2	1	0	0	9	9	9	11	11	10	1	1	0.8181818181818182	0.9	0.9045340337332909	0.9486832980505138
Mir-208	6	5	0	0	46	46	46	52	35	51	1	1	0.8846153846153846	0.9019607843137255	0.9405399431259602	0.9497161598676341
Mir-127	1	1	0	0	10	10	10	11	10	11	1	1	0.9090909090909091	0.9090909090909091	0.9534625892455924	0.9534625892455924
Mir-136	1	1	0	0	10	10	9	11	10	11	1	1	0.9090909090909091	0.9090909090909091	0.9534625892455924	0.9534625892455924
Mir-3059	1	1	0	0	10	10	10	11	10	11	1	1	0.9090909090909091	0.9090909090909091	0.9534625892455924	0.9534625892455924
Mir-342	1	1	0	0	10	10	10	11	10	11	1	1	0.9090909090909091	0.9090909090909091	0.9534625892455924	0.9534625892455924
Mir-433	1	1	0	0	10	10	10	11	10	11	1	1	0.9090909090909091	0.9090909090909091	0.9534625892455924	0.9534625892455924
Mir-493	22	1	0	0	10	10	10	32	10	11	1	1	0.3125	0.9090909090909091	0.5590169943749475	0.9534625892455924
Mir-504	1	1	0	0	10	10	10	11	10	11	1	1	0.9090909090909091	0.9090909090909091	0.9534625892455924	0.9534625892455924
Mir-505	1	1	0	0	10	10	10	11	10	11	1	1	0.9090909090909091	0.9090909090909091	0.9534625892455924	0.9534625892455924
Mir-722	195	1	0	0	10	10	10	205	31	11	1	1	0.04878048780487805	0.9090909090909091	0.2208630521496931	0.9534625892455924
Mir-133	56	12	2	3	166	165	168	222	71	177	0.9880952380952381	0.9821428571428571	0.7477477477477478	0.9322033898305084	0.8595615096349934	0.9568473758789289
Mir-727	32	1	0	0	11	11	11	43	31	12	1	1	0.2558139534883721	0.9166666666666666	0.5057805388588732	0.9574271077563381
Mir-965	2	1	0	0	11	11	11	13	11	12	1	1	0.8461538461538461	0.9166666666666666	0.9198662110077999	0.9574271077563381
Mir-210	22	4	2	3	80	79	79	102	71	83	0.975609756097561	0.9634146341463414	0.7843137254901961	0.9518072289156626	0.8747480336813908	0.9575933443918803
Mir-305	16	1	0	1	24	23	24	40	17	24	1	0.9583333333333334	0.6	0.9583333333333334	0.7745966692414834	0.9583333333333334
Mir-9	220	10	1	9	227	219	228	447	71	229	0.9956140350877193	0.9605263157894737	0.5078299776286354	0.9563318777292577	0.7110574190354475	0.9584268022062579
Mir-142	49	4	0	0	46	46	8	95	35	50	1	1	0.4842105263157895	0.92	0.6958523739384593	0.9591663046625439
Mir-338	7	4	1	1	59	59	60	66	35	63	0.9833333333333333	0.9833333333333333	0.8939393939393939	0.9365079365079365	0.9375715460914991	0.9596350717327243
Mir-34	23	16	3	5	256	254	258	279	71	270	0.9884169884169884	0.9806949806949807	0.9175627240143369	0.9407407407407408	0.9523311316731903	0.9605101366355915
Mir-124	18	13	0	2	183	181	123	201	71	194	1	0.9890710382513661	0.9104477611940298	0.9329896907216495	0.9541738631895289	0.9606211959351526
Mir-2001	35	2	0	0	24	24	24	59	71	26	1	1	0.4067796610169492	0.9230769230769231	0.6377928041432807	0.9607689228305228
Mir-725	37	1	0	0	12	12	12	49	33	13	1	1	0.24489795918367346	0.9230769230769231	0.4948716593053935	0.9607689228305228
Mir-137	27	6	0	2	101	99	65	128	71	105	1	0.9801980198019802	0.7890625	0.9428571428571428	0.8882919002219934	0.9613462978473075
Mir-750	1	1	1	1	25	25	26	26	28	26	0.9615384615384616	0.9615384615384616	0.9615384615384616	0.9615384615384616	0.9615384615384616	0.9615384615384616
Mir-375	7	5	1	1	75	75	76	82	71	80	0.9868421052631579	0.9868421052631579	0.9146341463414634	0.9375	0.9500523598840124	0.961854705079832
Mir-1662	5	1	0	0	13	13	13	18	25	14	1	1	0.7222222222222222	0.9285714285714286	0.8498365855987975	0.9636241116594315
Mir-71	62	2	0	1	42	41	42	104	71	43	1	0.9761904761904762	0.40384615384615385	0.9534883720930233	0.6354889093022426	0.964772650936774
Mir-1175	17	0	0	2	29	27	29	46	28	27	1	0.9310344827586207	0.6304347826086957	1	0.7939992333804207	0.9649012813540153
Mir-153	37	7	1	1	109	109	110	146	71	116	0.990909090909091	0.990909090909091	0.7465753424657534	0.9396551724137931	0.8601094662296671	0.9649418908227463
Mir-192	17	4	0	0	55	55	55	72	35	59	1	1	0.7638888888888888	0.9322033898305084	0.8740073734751262	0.9655068046526178
Mir-450	3	2	0	0	28	28	28	31	10	30	1	1	0.9032258064516129	0.9333333333333333	0.9503819266229829	0.9660917830792959
Mir-489	29	2	0	0	28	28	11	57	31	30	1	1	0.49122807017543857	0.9333333333333333	0.7008766440504623	0.9660917830792959
Mir-150	8	2	0	0	30	30	30	38	33	32	1	1	0.7894736842105263	0.9375	0.8885233166386386	0.9682458365518543
Mir-17	30	14	0	3	271	268	271	301	35	282	1	0.988929889298893	0.9003322259136213	0.950354609929078	0.9488583803253366	0.969450400583679
Mir-278	8	2	0	0	33	33	33	41	71	35	1	1	0.8048780487804879	0.9428571428571428	0.8971499589146108	0.9710083124552245
Mir-281	19	2	0	1	52	51	52	71	71	53	1	0.9807692307692307	0.7323943661971831	0.9622641509433962	0.8558004242796232	0.9714726301433106
Mir-196	22	6	0	0	101	101	101	123	36	107	1	1	0.8211382113821138	0.9439252336448598	0.9061667679749208	0.9715581473308017
Mir-67	29	2	0	0	34	34	34	63	28	36	1	1	0.5396825396825397	0.9444444444444444	0.7346308866924529	0.97182531580755
Mir-1994	3	0	0	1	18	17	18	21	9	17	1	0.9444444444444444	0.8571428571428571	1	0.9258200997725514	0.97182531580755
Let-7	79	15	9	14	511	507	521	590	71	522	0.9826923076923076	0.9731285988483686	0.8661016949152542	0.9712643678160919	0.9225570298211868	0.9721960364886395
Mir-7	96	5	1	4	162	159	163	258	71	164	0.9938650306748467	0.9754601226993865	0.627906976744186	0.9695121951219512	0.7899713834708258	0.9724816115547944
Mir-155	23	1	0	1	37	36	37	60	35	37	1	0.972972972972973	0.6166666666666667	0.972972972972973	0.7852812659593165	0.972972972972973
Mir-221	13	5	0	0	89	89	89	102	35	94	1	1	0.8725490196078431	0.9468085106382979	0.9341033238394151	0.9730408576407765
Mir-19	100	7	0	0	125	125	125	225	35	132	1	1	0.5555555555555556	0.946969696969697	0.7453559924999299	0.9731236802019038
Mir-8	69	6	0	4	185	181	185	254	71	187	1	0.9783783783783784	0.7283464566929134	0.9679144385026738	0.8534321629121517	0.9731323439035744
Mir-144	4	2	0	0	36	36	36	40	35	38	1	1	0.9	0.9473684210526315	0.9486832980505138	0.9733285267845752
Mir-599	3	1	0	0	18	18	18	21	26	19	1	1	0.8571428571428571	0.9473684210526315	0.9258200997725514	0.9733285267845752
Mir-135	17	3	2	3	111	110	113	128	38	113	0.9823008849557522	0.9734513274336283	0.8671875	0.9734513274336283	0.9229512710173633	0.9734513274336283
Mir-103	32	6	0	0	116	116	116	148	43	122	1	1	0.7837837837837838	0.9508196721311475	0.8853156407653622	0.9750998267516755
Mir-1	97	7	0	2	178	176	178	275	71	183	1	0.9887640449438202	0.6472727272727272	0.9617486338797814	0.8045326141759123	0.975162791258037
Mir-194	199	3	0	0	60	60	60	259	35	63	1	1	0.23166023166023167	0.9523809523809523	0.4813109511118895	0.9759000729485332
Mir-21	2	2	0	0	40	40	40	42	35	42	1	1	0.9523809523809523	0.9523809523809523	0.9759000729485332	0.9759000729485332
Mir-217	31	2	0	0	40	40	12	71	38	42	1	1	0.5633802816901409	0.9523809523809523	0.7505866250408015	0.9759000729485332
Mir-362	13	2	0	0	40	40	40	53	10	42	1	1	0.7547169811320755	0.9523809523809523	0.8687444855261388	0.9759000729485332
Mir-460	13	2	0	0	40	40	40	53	31	42	1	1	0.7547169811320755	0.9523809523809523	0.8687444855261388	0.9759000729485332
Mir-24	390	3	1	1	81	81	82	471	35	84	0.9878048780487805	0.9878048780487805	0.17197452229299362	0.9642857142857143	0.41216170615563963	0.9759744527415567
Mir-33	223	3	0	2	106	104	106	329	71	107	1	0.9811320754716981	0.3221884498480243	0.9719626168224299	0.5676164636865498	0.9765365838123493
Mir-456	3	1	0	0	21	21	21	24	35	22	1	1	0.875	0.9545454545454546	0.9354143466934853	0.9770084209183945
Mir-875	27	1	0	0	21	21	21	48	35	22	1	1	0.4375	0.9545454545454546	0.6614378277661477	0.9770084209183945
Mir-101	20	3	0	0	69	69	69	89	35	72	1	1	0.7752808988764045	0.9583333333333334	0.88050036847034	0.9789450103725609
Mir-383	1	1	0	0	25	25	13	26	25	26	1	1	0.9615384615384616	0.9615384615384616	0.9805806756909202	0.9805806756909202
Mir-32	34	1	0	0	27	27	27	61	33	28	1	1	0.4426229508196721	0.9642857142857143	0.6652991438591156	0.9819805060619657
Mir-204	8	3	0	0	83	83	83	91	35	86	1	1	0.9120879120879121	0.9651162790697675	0.9550329376979163	0.9824033179248569
Mir-26	13	4	0	0	111	111	111	124	35	115	1	1	0.8951612903225806	0.9652173913043478	0.9461296371653203	0.9824547782490285
Mir-148	19	3	0	0	86	86	86	105	35	89	1	1	0.819047619047619	0.9662921348314607	0.9050124966251124	0.9830015945213215
Mir-1388	4	1	0	0	29	29	29	33	33	30	1	1	0.8787878787878788	0.9666666666666667	0.937436866561092	0.983192080250175
Mir-205	15	2	0	0	59	59	59	74	35	61	1	1	0.7972972972972973	0.9672131147540983	0.8929150560368535	0.9834699358669274
Mir-23	8	3	0	0	90	90	90	98	35	93	1	1	0.9183673469387755	0.967741935483871	0.9583148474999099	0.9837387536759294
Mir-317	1	1	0	0	30	30	30	31	28	31	1	1	0.967741935483871	0.967741935483871	0.9837387536759294	0.9837387536759294
Mir-1306	2	1	0	0	34	34	34	36	33	35	1	1	0.9444444444444444	0.9714285714285714	0.97182531580755	0.9856107606091623
Mir-143	18	1	0	0	35	35	35	53	35	36	1	1	0.660377358490566	0.9722222222222222	0.8126360553720011	0.9860132971832694
Mir-145	73	1	0	0	35	35	35	108	35	36	1	1	0.32407407407407407	0.9722222222222222	0.5692750425533111	0.9860132971832694
Mir-223	18	1	0	0	35	35	35	53	35	36	1	1	0.660377358490566	0.9722222222222222	0.8126360553720011	0.9860132971832694
Mir-499	10	1	0	0	36	36	36	46	35	37	1	1	0.782608695652174	0.972972972972973	0.8846517369293828	0.9863939238321437
Mir-132	15	2	0	0	77	77	77	92	35	79	1	1	0.8369565217391305	0.9746835443037974	0.9148532788043832	0.9872606263311616
Mir-455	38	1	0	0	40	40	39	78	35	41	1	1	0.5128205128205128	0.975609756097561	0.7161148740394329	0.9877295966495896
Mir-130	10	5	0	0	214	214	214	224	35	219	1	1	0.9553571428571429	0.9771689497716894	0.9774237273860007	0.9885185631902365
Mir-27	5	2	0	0	92	92	92	97	35	94	1	1	0.9484536082474226	0.9787234042553191	0.9738858291644984	0.9893045053244826
Mir-181	7	4	0	0	208	208	208	215	35	212	1	1	0.9674418604651163	0.9811320754716981	0.9835862242147947	0.9905211130872972
Mir-551	2	1	0	0	52	52	52	54	35	53	1	1	0.9629629629629629	0.9811320754716981	0.9813067629253163	0.9905211130872972
Mir-30	11	4	0	0	219	219	219	230	35	223	1	1	0.9521739130434783	0.9820627802690582	0.9757939910880157	0.9909908073585033
Mir-138	2	1	0	0	70	70	70	72	35	71	1	1	0.9722222222222222	0.9859154929577465	0.9860132971832694	0.9929327736346235
Mir-146	5	1	0	0	74	74	72	79	35	75	1	1	0.9367088607594937	0.9866666666666667	0.9678372077779887	0.993310961716756
Mir-218	5	1	0	0	78	78	78	83	35	79	1	1	0.9397590361445783	0.9873417721518988	0.9694116958983826	0.99365072945774
Mir-129	16	1	0	0	89	89	89	105	38	90	1	1	0.8476190476190476	0.9888888888888889	0.9206622874969125	0.9944289260117533
Mir-199	14	1	0	0	96	96	96	110	35	97	1	1	0.8727272727272727	0.9896907216494846	0.9341987329938275	0.994832006747614
Mir-105	4	0	0	0	14	14	14	18	10	14	1	1	0.7777777777777778	1	0.8819171036881969	1
Mir-1180	0	0	0	0	2	2	2	2	2	2	1	1	1	1	1	1
Mir-122	17	0	0	0	38	38	38	55	35	38	1	1	0.6909090909090909	1	0.8312094145936335	1
Mir-1247	1	0	0	0	10	10	10	11	10	10	1	1	0.9090909090909091	1	0.9534625892455924	1
Mir-1249	0	0	0	0	10	10	10	10	10	10	1	1	1	1	1	1
Mir-1251	0	0	0	0	12	12	12	12	12	12	1	1	1	1	1	1
Mir-126	1	0	0	0	39	39	39	40	36	39	1	1	0.975	1	0.9874208829065749	1
Mir-1271	59	0	0	0	9	9	9	68	10	9	1	1	0.1323529411764706	1	0.36380343755449945	1
Mir-1277	16021	0	0	0	7	7	7	16028	10	7	1	1	4.3673571250311955e-4	1	0.02089822271158769	1
Mir-128	0	0	0	0	77	77	77	77	35	77	1	1	1	1	1	1
Mir-1296	0	0	0	0	8	8	8	8	10	8	1	1	1	1	1	1
Mir-1298	1	0	0	0	9	9	9	10	10	9	1	1	0.9	1	0.9486832980505138	1
Mir-1301	2	0	0	0	7	7	7	9	10	7	1	1	0.7777777777777778	1	0.8819171036881969	1
Mir-1307	0	0	0	0	6	6	6	6	10	6	1	1	1	1	1	1
Mir-1323	1	0	0	0	2	2	2	3	2	2	1	1	0.6666666666666666	1	0.816496580927726	1
Mir-1343	8	0	0	0	6	6	6	14	10	6	1	1	0.42857142857142855	1	0.6546536707079771	1
Mir-1379	4	0	0	0	1	1	1	5	10	1	1	1	0.2	1	0.44721359549995793	1
Mir-139	12	0	0	0	33	33	33	45	33	33	1	1	0.7333333333333333	1	0.8563488385776752	1
Mir-1397	0	0	0	0	10	10	10	10	22	10	1	1	1	1	1	1
Mir-140	7	0	0	0	39	39	39	46	35	39	1	1	0.8478260869565217	1	0.920774721067277	1
Mir-1416	5	0	0	0	6	6	6	11	22	6	1	1	0.5454545454545454	1	0.7385489458759964	1
Mir-149	2	0	0	0	10	10	10	12	10	10	1	1	0.8333333333333334	1	0.9128709291752769	1
Mir-1788	151	0	0	0	23	23	23	174	35	23	1	1	0.13218390804597702	1	0.3635710495157405	1
Mir-1805	3	0	0	0	15	15	15	18	25	15	1	1	0.8333333333333334	1	0.9128709291752769	1
Mir-1842	0	0	0	0	5	5	3	5	10	5	1	1	1	1	1	1
Mir-185	0	0	0	0	10	10	10	10	10	10	1	1	1	1	1	1
Mir-186	4	0	0	0	13	13	13	17	13	13	1	1	0.7647058823529411	1	0.8744746321952062	1
Mir-187	25	0	0	0	29	29	29	54	31	29	1	1	0.5370370370370371	1	0.73282810879294	1
Mir-188	1	0	0	0	26	26	26	27	10	26	1	1	0.9629629629629629	1	0.9813067629253163	1
Mir-191	4	0	0	0	32	32	32	36	33	32	1	1	0.8888888888888888	1	0.9428090415820634	1
Mir-1911	2	0	0	0	5	5	5	7	10	5	1	1	0.7142857142857143	1	0.8451542547285166	1
Mir-1912	2	0	0	0	9	9	9	11	10	9	1	1	0.8181818181818182	1	0.9045340337332909	1
Mir-202	20	0	0	0	37	37	37	57	35	37	1	1	0.6491228070175439	1	0.8056815791722831	1
Mir-203	29	0	0	0	42	42	32	71	35	42	1	1	0.5915492957746479	1	0.7691224192380871	1
Mir-2114	3	0	0	0	4	4	4	7	10	4	1	1	0.5714285714285714	1	0.7559289460184544	1
Mir-214	77	0	0	0	37	37	37	114	33	37	1	1	0.32456140350877194	1	0.5697029081098076	1
Mir-2188	4	0	0	0	24	24	24	28	33	24	1	1	0.8571428571428571	1	0.9258200997725514	1
Mir-224	2	0	0	0	9	9	9	11	10	9	1	1	0.8181818181818182	1	0.9045340337332909	1
Mir-2355	2	0	0	0	8	8	8	10	10	8	1	1	0.8	1	0.8944271909999159	1
Mir-2387	3	0	0	0	4	4	4	7	8	4	1	1	0.5714285714285714	1	0.7559289460184544	1
Mir-2483	2	0	0	0	4	4	4	6	10	4	1	1	0.6666666666666666	1	0.816496580927726	1
Mir-28	4	0	0	0	30	30	30	34	10	30	1	1	0.8823529411764706	1	0.9393364366277243	1
Mir-296	1	0	0	0	8	8	8	9	10	8	1	1	0.8888888888888888	1	0.9428090415820634	1
Mir-2970	7	0	0	0	17	17	17	24	26	17	1	1	0.7083333333333334	1	0.8416254115301732	1
Mir-3085	0	0	0	0	10	10	10	10	10	10	1	1	1	1	1	1
Mir-3140	0	0	0	0	2	2	2	2	2	2	1	1	1	1	1	1
Mir-3145	0	0	0	0	2	2	2	2	2	2	1	1	1	1	1	1
Mir-3146	0	0	0	0	2	2	2	2	2	2	1	1	1	1	1	1
Mir-3173	7	0	0	0	2	2	2	9	2	2	1	1	0.2222222222222222	1	0.4714045207910317	1
Mir-3200	11	0	0	0	2	2	2	13	2	2	1	1	0.15384615384615385	1	0.3922322702763681	1
Mir-324	0	0	0	0	10	10	10	10	10	10	1	1	1	1	1	1
Mir-325	296	0	0	0	8	8	8	304	12	8	1	1	0.02631578947368421	1	0.16222142113076254	1
Mir-326	1	0	0	0	10	10	10	11	10	10	1	1	0.9090909090909091	1	0.9534625892455924	1
Mir-328	1	0	0	0	10	10	10	11	10	10	1	1	0.9090909090909091	1	0.9534625892455924	1
Mir-330	0	0	0	0	10	10	10	10	10	10	1	1	1	1	1	1
Mir-331	0	0	0	0	10	10	10	10	10	10	1	1	1	1	1	1
Mir-335	1	0	0	0	10	10	10	11	10	10	1	1	0.9090909090909091	1	0.9534625892455924	1
Mir-339	8	0	0	0	10	10	10	18	10	10	1	1	0.5555555555555556	1	0.7453559924999299	1
Mir-340	77	0	0	0	13	13	13	90	12	13	1	1	0.14444444444444443	1	0.38005847503304596	1
Mir-345	5	0	0	0	9	9	9	14	10	9	1	1	0.6428571428571429	1	0.8017837257372732	1
Mir-346	1	0	0	0	9	9	9	10	10	9	1	1	0.9	1	0.9486832980505138	1
Mir-350	3	0	0	0	7	7	7	10	10	7	1	1	0.7	1	0.8366600265340756	1
Mir-361	0	0	0	0	10	10	10	10	10	10	1	1	1	1	1	1
Mir-3613	4	0	0	0	10	10	10	14	12	10	1	1	0.7142857142857143	1	0.8451542547285166	1
Mir-3617	0	0	0	0	2	2	2	2	2	2	1	1	1	1	1	1
Mir-374	2	0	0	0	14	14	14	16	10	14	1	1	0.875	1	0.9354143466934853	1
Mir-378	0	0	0	0	10	10	10	10	10	10	1	1	1	1	1	1
Mir-384	2	0	0	0	4	4	4	6	10	4	1	1	0.6666666666666666	1	0.816496580927726	1
Mir-3934	3	0	0	0	2	2	2	5	2	2	1	1	0.4	1	0.6324555320336759	1
Mir-4057	11	0	0	0	3	3	3	14	38	3	1	1	0.21428571428571427	1	0.4629100498862757	1
Mir-423	0	0	0	0	10	10	10	10	10	10	1	1	1	1	1	1
Mir-425	1	0	0	0	33	33	33	34	33	33	1	1	0.9705882352941176	1	0.985184366143778	1
Mir-431	0	0	0	0	9	9	9	9	10	9	1	1	1	1	1	1
Mir-448	1	0	0	0	9	9	9	10	10	9	1	1	0.9	1	0.9486832980505138	1
Mir-452	1	0	0	0	9	9	9	10	10	9	1	1	0.9	1	0.9486832980505138	1
Mir-4524	1	0	0	0	2	2	2	3	2	2	1	1	0.6666666666666666	1	0.816496580927726	1
Mir-4541	17	0	0	0	3	3	3	20	35	3	1	1	0.15	1	0.3872983346207417	1
Mir-458	8	0	0	0	20	20	20	28	31	20	1	1	0.7142857142857143	1	0.8451542547285166	1
Mir-459	4	0	0	0	27	27	27	31	35	27	1	1	0.8709677419354839	1	0.9332565252573828	1
Mir-4766	1	0	0	0	2	2	2	3	2	2	1	1	0.6666666666666666	1	0.816496580927726	1
Mir-483	122	0	0	0	11	11	11	133	12	11	1	1	0.08270676691729323	1	0.28758784208880117	1
Mir-486	7	0	0	0	10	10	10	17	10	10	1	1	0.5882352941176471	1	0.7669649888473704	1
Mir-490	0	0	0	0	22	22	22	22	22	22	1	1	1	1	1	1
Mir-491	0	0	0	0	9	9	9	9	10	9	1	1	1	1	1	1
Mir-498	0	0	0	0	2	2	2	2	2	2	1	1	1	1	1	1
Mir-511	1	0	0	0	5	5	5	6	6	5	1	1	0.8333333333333334	1	0.9128709291752769	1
Mir-542	0	0	0	0	12	12	12	12	10	12	1	1	1	1	1	1
Mir-550	1	0	0	0	5	5	5	6	2	5	1	1	0.8333333333333334	1	0.9128709291752769	1
Mir-574	4921	0	0	0	9	9	9	4930	10	9	1	1	0.0018255578093306288	1	0.04272654689219138	1
Mir-576	0	0	0	0	2	2	2	2	2	2	1	1	1	1	1	1
Mir-577	0	0	0	0	2	2	2	2	2	2	1	1	1	1	1	1
Mir-579	1	0	0	0	2	2	2	3	2	2	1	1	0.6666666666666666	1	0.816496580927726	1
Mir-582	1	0	0	0	9	9	9	10	10	9	1	1	0.9	1	0.9486832980505138	1
Mir-584	1	0	0	0	2	2	2	3	2	2	1	1	0.6666666666666666	1	0.816496580927726	1
Mir-589	0	0	0	0	2	2	2	2	2	2	1	1	1	1	1	1
Mir-590	3	0	0	0	7	7	7	10	13	7	1	1	0.7	1	0.8366600265340756	1
Mir-592	0	0	0	0	10	10	10	10	10	10	1	1	1	1	1	1
Mir-598	3	0	0	0	7	7	7	10	10	7	1	1	0.7	1	0.8366600265340756	1
Mir-605	1	0	0	0	2	2	0	3	2	2	1	1	0.6666666666666666	1	0.816496580927726	1
Mir-615	0	0	0	0	9	9	9	9	10	9	1	1	1	1	1	1
Mir-624	0	0	0	0	2	2	2	2	2	2	1	1	1	1	1	1
Mir-628	3	0	0	0	7	7	7	10	10	7	1	1	0.7	1	0.8366600265340756	1
Mir-642	0	0	0	0	2	2	2	2	2	2	1	1	1	1	1	1
Mir-651	0	0	0	0	2	2	2	2	2	2	1	1	1	1	1	1
Mir-652	6	0	0	0	10	10	10	16	10	10	1	1	0.625	1	0.7905694150420949	1
Mir-6529	0	0	0	0	8	8	8	8	10	8	1	1	1	1	1	1
Mir-653	0	0	0	0	9	9	9	9	10	9	1	1	1	1	1	1
Mir-670	2	0	0	0	8	8	8	10	10	8	1	1	0.8	1	0.8944271909999159	1
Mir-671	1	0	0	0	11	11	11	12	12	11	1	1	0.9166666666666666	1	0.9574271077563381	1
Mir-6715	0	0	0	0	9	9	9	9	10	9	1	1	1	1	1	1
Mir-672	701	0	0	0	6	6	6	707	10	6	1	1	0.008486562942008486	1	0.09212254307176114	1
Mir-7147	2	0	0	0	9	9	9	11	31	9	1	1	0.8181818181818182	1	0.9045340337332909	1
Mir-7180	1	0	0	0	5	5	5	6	10	5	1	1	0.8333333333333334	1	0.9128709291752769	1
Mir-737	36	0	0	0	15	15	15	51	31	15	1	1	0.29411764705882354	1	0.5423261445466404	1
Mir-744	0	0	0	0	10	10	10	10	10	10	1	1	1	1	1	1
Mir-769	2	0	0	0	7	7	7	9	10	7	1	1	0.7777777777777778	1	0.8819171036881969	1
Mir-770	0	0	0	0	4	4	4	4	6	4	1	1	1	1	1	1
Mir-873	0	0	0	0	12	12	12	12	13	12	1	1	1	1	1	1
Mir-874	0	0	0	0	10	10	10	10	10	10	1	1	1	1	1	1
Mir-876	1	0	0	0	9	9	9	10	10	9	1	1	0.9	1	0.9486832980505138	1
Mir-885	0	0	0	0	7	7	7	7	10	7	1	1	1	1	1	1
Mir-887	0	0	0	0	2	2	2	2	2	2	1	1	1	1	1	1
Mir-934	0	0	0	0	2	2	2	2	2	2	1	1	1	1	1	1
Mir-935	0	0	0	0	8	8	8	8	10	8	1	1	1	1	1	1
Mir-944	0	0	0	0	2	2	2	2	2	2	1	1	1	1	1	1
Mir-95	73	0	0	0	30	30	30	103	10	30	1	1	0.2912621359223301	1	0.5396870722208659	1
Mir-9851	2	0	0	0	6	6	6	8	10	6	1	1	0.75	1	0.8660254037844386	1
Mir-1955	0	0	0	0	2	2	2	2	2	2	1	1	1	1	1	1
Mir-1962	0	0	0	0	3	3	3	3	2	3	1	1	1	1	1	1
Mir-298	0	0	0	0	2	2	2	2	2	2	1	1	1	1	1	1
Mir-3068	0	0	0	0	2	2	2	2	2	2	1	1	1	1	1	1
Mir-3072	0	0	0	0	2	2	2	2	2	2	1	1	1	1	1	1
Mir-3075	0	0	0	0	2	2	2	2	2	2	1	1	1	1	1	1
Mir-3099	1	0	0	0	2	2	2	3	2	2	1	1	0.6666666666666666	1	0.816496580927726	1
Mir-3112	2	0	0	0	2	2	2	4	2	2	1	1	0.5	1	0.7071067811865476	1
Mir-351	2	0	0	0	1	1	1	3	2	1	1	1	0.3333333333333333	1	0.5773502691896257	1
Mir-540	0	0	0	0	2	2	2	2	2	2	1	1	1	1	1	1
Mir-666	0	0	0	0	2	2	2	2	2	2	1	1	1	1	1	1
Mir-667	0	0	0	0	2	2	2	2	2	2	1	1	1	1	1	1
Mir-673	0	0	0	0	2	2	2	2	2	2	1	1	1	1	1	1
Mir-674	0	0	0	0	2	2	2	2	2	2	1	1	1	1	1	1
Mir-700	0	0	0	0	2	2	2	2	2	2	1	1	1	1	1	1
Mir-872	0	0	0	0	4	4	4	4	4	4	1	1	1	1	1	1
Mir-879	2	0	0	0	2	2	2	4	2	2	1	1	0.5	1	0.7071067811865476	1
Mir-12316	1	0	0	0	3	3	3	4	2	3	1	1	0.75	1	0.8660254037844386	1
Mir-12355	1	0	0	0	2	2	2	3	2	2	1	1	0.6666666666666666	1	0.816496580927726	1
Mir-12358	0	0	0	0	2	2	0	2	2	2	1	1	1	1	1	1
Mir-12366	1	0	0	0	2	2	2	3	2	2	1	1	0.6666666666666666	1	0.816496580927726	1
Mir-12380	0	0	0	0	2	2	2	2	2	2	1	1	1	1	1	1
Mir-12404	1	0	0	0	2	2	2	3	2	2	1	1	0.6666666666666666	1	0.816496580927726	1
Mir-1540	0	0	0	0	2	2	2	2	2	2	1	1	1	1	1	1
Mir-1541	1	0	0	0	2	2	2	3	2	2	1	1	0.6666666666666666	1	0.816496580927726	1
Mir-1542	3	0	0	0	2	2	2	5	2	2	1	1	0.4	1	0.6324555320336759	1
Mir-1546	1	0	0	0	2	2	2	3	2	2	1	1	0.6666666666666666	1	0.816496580927726	1
Mir-1547	0	0	0	0	2	2	2	2	2	2	1	1	1	1	1	1
Mir-1549	0	0	0	0	2	2	2	2	2	2	1	1	1	1	1	1
Mir-7246	0	0	0	0	2	2	2	2	2	2	1	1	1	1	1	1
Mir-7247	0	0	0	0	2	2	2	2	2	2	1	1	1	1	1	1
Mir-7251	0	0	0	0	2	2	2	2	2	2	1	1	1	1	1	1
Mir-7254	0	0	0	0	2	2	0	2	2	2	1	1	1	1	1	1
Mir-7281	33	0	0	0	2	2	2	35	2	2	1	1	0.05714285714285714	1	0.23904572186687872	1
Mir-7284	8	0	0	0	2	2	2	10	2	2	1	1	0.2	1	0.44721359549995793	1
Mir-7286	0	0	0	0	2	2	2	2	2	2	1	1	1	1	1	1
Mir-7292	0	0	0	0	2	2	2	2	2	2	1	1	1	1	1	1
Mir-7293	0	0	0	0	2	2	2	2	2	2	1	1	1	1	1	1
Mir-7303	1	0	0	0	4	4	4	5	2	4	1	1	0.8	1	0.8944271909999159	1
Mir-7304	1	0	0	0	2	2	2	3	2	2	1	1	0.6666666666666666	1	0.816496580927726	1
Mir-7309	0	0	0	0	2	2	2	2	2	2	1	1	1	1	1	1
Mir-7319	533	0	0	0	2	2	2	535	2	2	1	1	0.003738317757009346	1	0.061141784051574305	1
Mir-7323	0	0	0	0	2	2	2	2	2	2	1	1	1	1	1	1
Mir-7327	0	0	0	0	2	2	2	2	2	2	1	1	1	1	1	1
Mir-7332	0	0	0	0	2	2	2	2	2	2	1	1	1	1	1	1
Mir-7333	0	0	0	0	2	2	2	2	2	2	1	1	1	1	1	1
Mir-7336	1	0	0	0	2	2	2	3	2	2	1	1	0.6666666666666666	1	0.816496580927726	1
Mir-7363	0	0	0	0	2	2	2	2	2	2	1	1	1	1	1	1
Mir-7368	0	0	0	0	2	2	2	2	2	2	1	1	1	1	1	1
Mir-7370	4	0	0	0	2	2	2	6	2	2	1	1	0.3333333333333333	1	0.5773502691896257	1
Mir-7376	0	0	0	0	2	2	2	2	2	2	1	1	1	1	1	1
Mir-7377	0	0	0	0	2	2	2	2	2	2	1	1	1	1	1	1
Mir-7378	0	0	0	0	2	2	2	2	2	2	1	1	1	1	1	1
Mir-7379	0	0	0	0	2	2	2	2	2	2	1	1	1	1	1	1
Mir-7383	0	0	0	0	8	8	8	8	2	8	1	1	1	1	1	1
Mir-7394	2	0	0	0	6	6	6	8	2	6	1	1	0.75	1	0.8660254037844386	1
Mir-7397	3	0	0	0	2	2	2	5	2	2	1	1	0.4	1	0.6324555320336759	1
Mir-1451	1	0	0	0	3	3	3	4	3	3	1	1	0.75	1	0.8660254037844386	1
Mir-1467	3	0	0	0	3	3	3	6	3	3	1	1	0.5	1	0.7071067811865476	1
Mir-1559	0	0	0	0	3	3	3	3	3	3	1	1	1	1	1	1
Mir-1641	10	0	0	0	4	4	4	14	4	4	1	1	0.2857142857142857	1	0.5345224838248488	1
Mir-1720	1	0	0	0	9	9	9	10	9	9	1	1	0.9	1	0.9486832980505138	1
Mir-1729	0	0	0	0	3	3	3	3	3	3	1	1	1	1	1	1
Mir-1781	0	0	0	0	3	3	3	3	3	3	1	1	1	1	1	1
Mir-2131	0	0	0	0	3	3	3	3	3	3	1	1	1	1	1	1
Mir-2954	2	0	0	0	3	3	3	5	3	3	1	1	0.6	1	0.7745966692414834	1
Mir-2984	1	0	0	0	3	3	3	4	3	3	1	1	0.75	1	0.8660254037844386	1
Mir-7463	7	0	0	0	6	6	6	13	9	6	1	1	0.46153846153846156	1	0.6793662204867574	1
Mir-9619	1	0	0	0	2	2	2	3	2	2	1	1	0.6666666666666666	1	0.816496580927726	1
Mir-7132	0	0	0	0	6	6	6	6	4	6	1	1	1	1	1	1
Mir-7133	6	0	0	0	4	4	4	10	4	4	1	1	0.4	1	0.6324555320336759	1
Mir-723	0	0	0	0	8	8	8	8	4	8	1	1	1	1	1	1
Mir-728	2	0	0	0	7	7	7	9	5	7	1	1	0.7777777777777778	1	0.8819171036881969	1
Mir-729	0	0	0	0	2	2	2	2	5	2	1	1	1	1	1	1
Mir-8160	0	0	0	0	5	5	5	5	3	5	1	1	1	1	1	1
Mir-4542	0	0	0	0	2	2	2	2	2	2	1	1	1	1	1	1
Mir-4543	1	0	0	0	2	2	2	3	2	2	1	1	0.6666666666666666	1	0.816496580927726	1
Mir-4544	0	0	0	0	2	2	2	2	2	2	1	1	1	1	1	1
Mir-4545	2	0	0	0	3	3	3	5	2	3	1	1	0.6	1	0.7745966692414834	1
Mir-2056	3	0	0	0	3	3	3	6	2	3	1	1	0.5	1	0.7071067811865476	1
Mir-2057	2	0	0	0	2	2	2	4	2	2	1	1	0.5	1	0.7071067811865476	1
Mir-2058	2	0	0	0	2	2	2	4	2	2	1	1	0.5	1	0.7071067811865476	1
Mir-2061	0	0	0	0	2	2	2	2	2	2	1	1	1	1	1	1
Mir-2062	1	0	0	0	2	2	2	3	2	2	1	1	0.6666666666666666	1	0.816496580927726	1
Mir-2068	0	0	0	0	2	2	2	2	2	2	1	1	1	1	1	1
Mir-2070	0	0	0	0	3	3	3	3	2	3	1	1	1	1	1	1
Mir-2071	0	0	0	0	2	2	2	2	2	2	1	1	1	1	1	1
Mir-2072	0	0	0	0	2	2	2	2	2	2	1	1	1	1	1	1
Mir-2076	0	0	0	0	2	2	2	2	2	2	1	1	1	1	1	1
Mir-4857	0	0	0	0	2	2	2	2	2	2	1	1	1	1	1	1
Mir-4859	1	0	0	0	2	2	2	3	2	2	1	1	0.6666666666666666	1	0.816496580927726	1
Mir-4860	0	0	0	0	2	2	2	2	2	2	1	1	1	1	1	1
Mir-4861	0	0	0	0	2	2	2	2	2	2	1	1	1	1	1	1
Mir-4862	3	0	0	0	2	2	2	5	2	2	1	1	0.4	1	0.6324555320336759	1
Mir-4863	0	0	0	0	2	2	2	2	2	2	1	1	1	1	1	1
Mir-4864	0	0	0	0	2	2	2	2	2	2	1	1	1	1	1	1
Mir-4865	0	0	0	0	2	2	2	2	2	2	1	1	1	1	1	1
Mir-4866	1	0	0	0	2	2	2	3	2	2	1	1	0.6666666666666666	1	0.816496580927726	1
Mir-4869	0	0	0	0	2	2	2	2	2	2	1	1	1	1	1	1
Mir-4871	0	0	0	0	2	2	2	2	2	2	1	1	1	1	1	1
Mir-4873	0	0	0	0	2	2	2	2	2	2	1	1	1	1	1	1
Mir-4874	0	0	0	0	2	2	2	2	2	2	1	1	1	1	1	1
Mir-4876	0	0	0	0	3	3	3	3	2	3	1	1	1	1	1	1
Mir-4879	2	0	0	0	2	2	2	4	2	2	1	1	0.5	1	0.7071067811865476	1
Mir-4880	3	0	0	0	2	2	2	5	2	2	1	1	0.4	1	0.6324555320336759	1
Mir-4886	0	0	0	0	2	2	2	2	2	2	1	1	1	1	1	1
Mir-4887	0	0	0	0	2	2	2	2	2	2	1	1	1	1	1	1
Mir-4888	0	0	0	0	2	2	2	2	2	2	1	1	1	1	1	1
Mir-4891	0	0	0	0	2	2	2	2	2	2	1	1	1	1	1	1
Mir-2006	1	0	0	0	4	4	4	5	4	4	1	1	0.8	1	0.8944271909999159	1
Mir-2012	13	0	0	0	4	4	4	17	4	4	1	1	0.23529411764705882	1	0.48507125007266594	1
Mir-4818	1	0	0	0	13	13	13	14	2	13	1	1	0.9285714285714286	1	0.9636241116594315	1
Mir-4819	0	0	0	0	2	2	2	2	2	2	1	1	1	1	1	1
Mir-4820	0	0	0	0	2	2	2	2	2	2	1	1	1	1	1	1
Mir-4824	0	0	0	0	2	2	2	2	2	2	1	1	1	1	1	1
Mir-4825	0	0	0	0	3	3	3	3	2	3	1	1	1	1	1	1
Mir-4826	0	0	0	0	2	2	2	2	2	2	1	1	1	1	1	1
Mir-4828	1	0	0	0	8	8	8	9	2	8	1	1	0.8888888888888888	1	0.9428090415820634	1
Mir-4829	0	0	0	0	6	6	6	6	2	6	1	1	1	1	1	1
Mir-4830	0	0	0	0	8	8	8	8	2	8	1	1	1	1	1	1
Mir-4831	0	0	0	0	2	2	2	2	2	2	1	1	1	1	1	1
Mir-4835	1	0	0	0	2	2	2	3	2	2	1	1	0.6666666666666666	1	0.816496580927726	1
Mir-4838	0	0	0	0	2	2	2	2	2	2	1	1	1	1	1	1
Mir-4839	0	0	0	0	2	2	2	2	2	2	1	1	1	1	1	1
Iab-4	20	0	0	0	18	18	18	38	14	18	1	1	0.47368421052631576	1	0.6882472016116853	1
Mir-1000	0	0	0	0	10	10	10	10	9	10	1	1	1	1	1	1
Mir-1003	0	0	0	0	5	5	5	5	5	5	1	1	1	1	1	1
Mir-1006	0	0	0	0	5	5	5	5	5	5	1	1	1	1	1	1
Mir-1010	0	0	0	0	5	5	5	5	5	5	1	1	1	1	1	1
Mir-14	1	0	0	0	9	9	9	10	9	9	1	1	0.9	1	0.9486832980505138	1
Mir-275	0	0	0	0	18	18	18	18	14	18	1	1	1	1	1	1
Mir-276	5	0	0	0	28	28	28	33	14	28	1	1	0.8484848484848485	1	0.9211323729436766	1
Mir-2765	0	0	0	0	4	4	4	4	11	4	1	1	1	1	1	1
Mir-2796	0	0	0	0	4	4	4	4	9	4	1	1	1	1	1	1
Mir-282	67	0	0	0	12	12	12	79	11	12	1	1	0.1518987341772152	1	0.3897418814769785	1
Mir-284	0	0	0	0	5	5	5	5	5	5	1	1	1	1	1	1
Mir-3049	0	0	0	0	2	2	2	2	9	2	1	1	1	1	1	1
Mir-306	0	0	0	0	8	8	8	8	9	8	1	1	1	1	1	1
Mir-314	0	0	0	0	5	5	5	5	5	5	1	1	1	1	1	1
Mir-927	0	0	0	0	13	13	13	13	9	13	1	1	1	1	1	1
Mir-929	0	0	0	0	10	10	10	10	9	10	1	1	1	1	1	1
Mir-932	1	0	0	0	9	9	9	10	9	9	1	1	0.9	1	0.9486832980505138	1
Mir-955	0	0	0	0	5	5	5	5	5	5	1	1	1	1	1	1
Mir-956	0	0	0	0	5	5	5	5	5	5	1	1	1	1	1	1
Mir-957	1	0	0	0	7	7	7	8	7	7	1	1	0.875	1	0.9354143466934853	1
Mir-960	0	0	0	0	5	5	5	5	5	5	1	1	1	1	1	1
Mir-962	0	0	0	0	5	5	5	5	5	5	1	1	1	1	1	1
Mir-963	0	0	0	0	5	5	3	5	5	5	1	1	1	1	1	1
Mir-964	0	0	0	0	5	5	5	5	5	5	1	1	1	1	1	1
Mir-969	0	0	0	0	5	5	5	5	5	5	1	1	1	1	1	1
Mir-970	0	0	0	0	8	8	8	8	8	8	1	1	1	1	1	1
Mir-971	1	0	0	0	9	9	8	10	9	9	1	1	0.9	1	0.9486832980505138	1
Mir-973	0	0	0	0	4	4	4	4	5	4	1	1	1	1	1	1
Mir-974	1	0	0	0	4	4	4	5	5	4	1	1	0.8	1	0.8944271909999159	1
Mir-975	6	0	0	0	5	5	5	11	5	5	1	1	0.45454545454545453	1	0.674199862463242	1
Mir-976	0	0	0	0	5	5	5	5	5	5	1	1	1	1	1	1
Mir-977	0	0	0	0	5	5	5	5	5	5	1	1	1	1	1	1
Mir-987	0	0	0	0	5	5	5	5	5	5	1	1	1	1	1	1
Mir-988	1	0	0	0	7	7	7	8	7	7	1	1	0.875	1	0.9354143466934853	1
Mir-989	0	0	0	0	9	9	9	9	8	9	1	1	1	1	1	1
Mir-999	1	0	0	0	6	6	6	7	7	6	1	1	0.8571428571428571	1	0.9258200997725514	1
Mir-3931	6	0	0	0	10	10	10	16	3	10	1	1	0.625	1	0.7905694150420949	1
Mir-5305	14	0	0	0	12	12	12	26	3	12	1	1	0.46153846153846156	1	0.6793662204867574	1
Mir-5735	31	0	0	0	3	3	3	34	3	3	1	1	0.08823529411764706	1	0.2970442628930023	1
Lsy-6	0	0	0	0	2	2	2	2	2	2	1	1	1	1	1	1
Mir-1817	1	0	0	0	2	2	2	3	2	2	1	1	0.6666666666666666	1	0.816496580927726	1
Mir-230	0	0	0	0	2	2	2	2	2	2	1	1	1	1	1	1
Mir-231	0	0	0	0	2	2	2	2	2	2	1	1	1	1	1	1
Mir-238	1	0	0	0	2	2	2	3	2	2	1	1	0.6666666666666666	1	0.816496580927726	1
Mir-246	0	0	0	0	2	2	2	2	2	2	1	1	1	1	1	1
Mir-248	0	0	0	0	2	2	2	2	2	2	1	1	1	1	1	1
Mir-249	1	0	0	0	2	2	2	3	2	2	1	1	0.6666666666666666	1	0.816496580927726	1
Mir-253	0	0	0	0	2	2	2	2	2	2	1	1	1	1	1	1
Mir-254	0	0	0	0	2	2	2	2	2	2	1	1	1	1	1	1
Mir-255	1	0	0	0	2	2	2	3	2	2	1	1	0.6666666666666666	1	0.816496580927726	1
Mir-355	0	0	0	0	2	2	2	2	2	2	1	1	1	1	1	1
Mir-357	0	0	0	0	3	3	3	3	2	3	1	1	1	1	1	1
Mir-358	0	0	0	0	2	2	2	2	2	2	1	1	1	1	1	1
Mir-392	2	0	0	0	2	2	2	4	2	2	1	1	0.5	1	0.7071067811865476	1
Mir-4813	1	0	0	0	2	2	2	3	2	2	1	1	0.6666666666666666	1	0.816496580927726	1
Mir-52	0	0	0	0	3	3	3	3	2	3	1	1	1	1	1	1
Mir-54	2	0	0	0	11	11	11	13	3	11	1	1	0.8461538461538461	1	0.9198662110077999	1
Mir-62	0	0	0	0	2	2	2	2	2	2	1	1	1	1	1	1
Mir-64	0	0	0	0	7	7	7	7	2	7	1	1	1	1	1	1
Mir-70	0	0	0	0	2	2	2	2	2	2	1	1	1	1	1	1
Mir-73	0	0	0	0	8	8	8	8	2	8	1	1	1	1	1	1
Mir-77	2	0	0	0	4	4	4	6	3	4	1	1	0.6666666666666666	1	0.816496580927726	1
Mir-784	0	0	0	0	2	2	2	2	2	2	1	1	1	1	1	1
Mir-785	0	0	0	0	3	3	3	3	2	3	1	1	1	1	1	1
Mir-787	0	0	0	0	2	2	2	2	2	2	1	1	1	1	1	1
Mir-788	7	0	0	0	2	2	2	9	2	2	1	1	0.2222222222222222	1	0.4714045207910317	1
Mir-789	2	0	0	0	3	3	3	5	2	3	1	1	0.6	1	0.7745966692414834	1
Mir-791	1	0	0	0	3	3	3	4	3	3	1	1	0.75	1	0.8660254037844386	1
Mir-85	1	0	0	0	2	2	2	3	2	2	1	1	0.6666666666666666	1	0.816496580927726	1
Mir-86	17	0	0	0	3	3	3	20	3	3	1	1	0.15	1	0.3872983346207417	1
Mir-90	0	0	0	0	3	3	3	3	2	3	1	1	1	1	1	1
Mir-1987	0	0	0	0	2	2	2	2	2	2	1	1	1	1	1	1
Mir-1989	13	0	0	0	8	8	8	21	10	8	1	1	0.38095238095238093	1	0.6172133998483676	1
Mir-1992	3	0	0	0	13	13	12	16	10	13	1	1	0.8125	1	0.9013878188659973	1
Mir-1995	2	0	0	0	3	3	3	5	2	3	1	1	0.6	1	0.7745966692414834	1
Mir-1996	0	0	0	0	4	4	4	4	2	4	1	1	1	1	1	1
Mir-2685	2	0	0	0	5	5	5	7	2	5	1	1	0.7142857142857143	1	0.8451542547285166	1
Mir-2687	0	0	0	0	2	2	2	2	2	2	1	1	1	1	1	1
Mir-2689	0	0	0	0	3	3	3	3	2	3	1	1	1	1	1	1
Mir-2691	5	0	0	0	5	5	5	10	2	5	1	1	0.5	1	0.7071067811865476	1
Mir-2693	3	0	0	0	3	3	3	6	2	3	1	1	0.5	1	0.7071067811865476	1
Mir-2705	0	0	0	0	2	2	2	2	2	2	1	1	1	1	1	1
Mir-1984	2	0	0	0	8	8	8	10	6	8	1	1	0.8	1	0.8944271909999159	1
Mir-1985	0	0	0	0	2	2	2	2	6	2	1	1	1	1	1	1
Mir-2722	0	0	0	0	6	6	6	6	6	6	1	1	1	1	1	1
Mir-2022	10	0	0	0	2	2	2	12	2	2	1	1	0.16666666666666666	1	0.408248290463863	1
Mir-2030	10	0	0	0	2	2	2	12	2	2	1	1	0.16666666666666666	1	0.408248290463863	1
Mir-2014	4	0	0	0	3	3	3	7	2	3	1	1	0.42857142857142855	1	0.6546536707079771	1
Mir-2015	9	0	0	0	2	2	2	11	2	2	1	1	0.18181818181818182	1	0.4264014327112209	1
Mir-2017	6	0	0	0	3	3	3	9	2	3	1	1	0.3333333333333333	1	0.5773502691896257	1
Mir-2018	2	0	0	0	3	3	3	5	2	3	1	1	0.6	1	0.7745966692414834	1
Mir-2019	0	0	0	0	2	2	2	2	2	2	1	1	1	1	1	1
Mir-2020	0	0	0	0	1	1	1	1	2	1	1	1	1	1	1	1
Mir-2021	1	0	0	0	1	1	1	2	2	1	1	1	0.5	1	0.7071067811865476	1
